{
    "total_population": {
        "1960": "3032019978",
        "1961": "3073077563",
        "1962": "3126066253",
        "1963": "3191186048",
        "1964": "3256700083",
        "1965": "3323623700",
        "1966": "3393699205",
        "1967": "3463147267",
        "1968": "3533536526",
        "1969": "3608235815",
        "1970": "3683676306",
        "1971": "3761307048",
        "1972": "3837726171",
        "1973": "3913217944",
        "1974": "3989385034",
        "1975": "4063806523",
        "1976": "4136393107",
        "1977": "4208770941",
        "1978": "4282341460",
        "1979": "4357793599",
        "1980": "4434021975",
        "1981": "4512268962",
        "1982": "4593454253",
        "1983": "4675367633",
        "1984": "4756998073",
        "1985": "4840155168",
        "1986": "4925801334",
        "1987": "5013576387",
        "1988": "5102293348",
        "1989": "5190965222",
        "1990": "5281340078",
        "1991": "5369210095",
        "1992": "5453393960",
        "1993": "5538448726",
        "1994": "5622575421",
        "1995": "5707533023",
        "1996": "5790454220",
        "1997": "5873071768",
        "1998": "5954810550",
        "1999": "6035284135",
        "2000": "6115108363",
        "2001": "6194460444",
        "2002": "6273526441",
        "2003": "6352677699",
        "2004": "6432374971",
        "2005": "6512602867",
        "2006": "6593623202",
        "2007": "6675130418",
        "2008": "6757887172",
        "2009": "6840591577",
        "2010": "6922947261",
        "2011": "7004011262",
        "2012": "7086993625",
        "2013": "7170961674",
        "2014": "7255653881",
        "2015": "7340548192",
        "2016": "7426103221",
        "2017": "7510990456",
        "2018": "7594270356"
    },
    "poverty_percent": {
        "1981": "42.1",
        "1984": "39.2",
        "1987": "35.3",
        "1990": "35.9",
        "1993": "34.0",
        "1996": "29.4",
        "1999": "28.6",
        "2002": "25.5",
        "2005": "20.7",
        "2008": "18.2",
        "2010": "15.7",
        "2011": "13.7",
        "2012": "12.8",
        "2013": "11.2",
        "2015": "10.0"
    }
}